####################################################################################################
##....................[]......##..[][]....##..[][]..[]......##[]....##[]............[]....[]......##
####[]....[][]..[][][][][]........##..##..##[]......##....[]........##........[]..[][][]..........##
##..[]......[]..[]##....[]....[][]............[]....[][]....##[]............[]..##........[]......##
##....[]..[]..[][]....[]....[][]##[]..[]##[]........................[]..[]..##[]..................##
##........[]....[]....[]....[][]..[][]..[]..[]........[]..[]..[]........[]..........[]............##
##..[]##..[]..[][][]....[]......[]......[][]........[][]........##......##[][]....[]....[]..##....##
##....[]..[]..##....................[]....[]..[]......[][]........[]......[][]##......[]..........##
##[]....##......[][][]........##........##........####..................[]......[]................##
##..##..[][]##[]....##..[]............[]..##........[]..[]..................[]##........####[]....##
##..[][]..##................[][]..[]........[]................####[]............[]..........[][][]##
##........[]....[][]..####................................[][]......[]....[]....[]..[]..[]..[][][]##
####......[]..............[]............[][]..[]##..........[]..[]................[]........[][]..##
##..##..[]..........[]....##..[]..........[]######......[]....[]..[]##....[][]..##....[]##[]##[][]##
##..........[]....................[]......[]..##[]..............##......[]....[]........[]........##
##....##[]..##[]........##......##..[]....##..##[]..............[]........[][]..[]....####....[]..##
####....[]..[]........##..[]....##..[]....##......[]..........####..[][]................[]........##
##[]..##....##[][]..[]............[]##......[]##........##..[]..##..[]..[]........[]........[]##[]##
##......[]....[]..[]......##..[][]................................[][]............[][]..[]..[][]####
####[]..........[][]....[]....[]..[]......................[]..............[][][][]........[]##....##
##[]......##........##[][][]........[]......[]......[]........##..[][][]....[][]........##..[][][]##
##..[][]....[]..[]##[][][]..[]......[][]........[]....[]..[]##[]........[]##....................[]##
##[]....[]................[][][]..........[]..[]..............[]..[][]##..........##[]........[]..##
##..##....[]..[]..[]##......[]..........##......[]............[]..[]..........##........[]..##....##
##[]....[][]....[]............[]..[]....[]......@.[]..[]......[][]......[]##....[]..[]....[]....[]##
##..[]......[]..............##..[]......[]....[]............##[]....##..##..............[]....[]..##
##..........##[]....##..........[]....[][]##[]..............[]..[]....[][]........##..[][]........##
##..[][]..[][]..##........[]......[]..##..[][]..[]....[]..[]..####..........[][][]................##
##............[]......[]..[]..[]..[]....................##[]........[]........[][][][]........[]..##
##..[][]........[][]....[]......[]......[]..[]..[]..####........[][][]......##............[]..[]..##
##....[][]................[]..[]....[][][]....[]....####[]............##[]..[]..[]..[]..##....[][]##
##....##..##......[]##..[]##......[]##[][][]..........[]##..........[][]......##........[][]....####
##..[]....[]....[]..[][]....##[]....[]....[][]..[]..[]..##..[][]............[]..##......##....##..##
##....##..##[][]............................[]....[]............##....[]..[][]..[][]....[][]####..##
##..[]..............##....##........[][]..##....[][][]....[]....[]....................[]..[]..[]..##
##..[]##........[]......##..[]..[]......[]....##....[]..[]........[]##..[][]......................##
##..##....[][][]....[]..........[]........##....[]..[][][][]........##........##......[]....[]....##
##..##....[][]..[]..[]..[]........[]..................[]##..........[]..[]..[]....[]........##..[]##
####........[]..[][]..##..........[][]......##....[]..[]..##..[]..[][]..............[]..[]....[][]##
##[]##....[]................[]........[]....##..[]##......[]..##......[][][][]##..............[]..##
##....[]....##......##[]..............####..[]....[]..[]....[]..[]..[]............................##
##................[][]..##..[]##..........##....[]..[]......[]##..##........[][]##....[]..........##
##......[]......[]..........##..[]..............##....[]....[]##..##[]....[]......[][][]........####
##....[]..[][]........[][]..[]......[]....[][]......##..##[]......[]..............[][][]..........##
##....[][]..[]..[]........##[]..[]##............[]........[]##[][]..[][]............[][]......[]..##
####..........##[]..[][]..##................[]..####[]..[]##....##..................[]..........[]##
##[]......##[][]....####[][]......##....................[]......[]....##..........[]........[]..[]##
##[]##..[]..........[]....##[]........[]....[]....[]..........[]##..[]................[]..[]......##
##..............##..##....[]....[]..........[]............##..[]....[]##....##........[]..........##
####################################################################################################
